111111111111111111111111111111
1P0E00000000000000000000000001
10000000C000000000000000000001
100000000000000000000000000001
100000000000000000000000000NE1
111111111111111111111111111111